UpdatePetSkillAndState
AA55
AF00
00549C
6B00
A000
6300
1A01
7E01
6B00
5700
0000
00000000
054B0B00
064B0B00
074B0B00
00000000
00000000
00000000
00000000
00000000
00000000
00000000
00000000
00000000
00000000
00000000
00000000
00000000
C5AE0A00
C6AE0A00
C7AE0A00
00000000
29AF0A00
00000000
00000000
00000000
8DAF0A00
00000000
00000000
00000000
F1AF0A00
00000000
00000000
00000000
00000000
00000000
00000000
00000000
0000000000000000
55AA